type octile
width 100
height 100
ground 1
tree +inf
swamp 10
water 20
map
....................................................................................................
....................................................................................................
....................................................................................................
....................................................................................................
....................................................................................................
....................................................................................................
....................................................................................................
....................................................................................................
....................................................................................................
....................................................................................................
....................................................................................................
....................................................................................................
....................................................................................................
....................................................................................................
....................................................................................................
.....................................................WWWWWW.........................................
....................................................WWWWWWWW........................................
...................................................WWWWWWWWWWWWWWWWW................................
..................................................WWWWWWWWWWWWWWWWWWW...............................
.................................................WWWWWWWWWWWWWWWWWWWWW..............................
.................................................WWWWWWWWWWWWWWWWWWWWW..............................
.................................................WWWWWWWWWWWWWWWWWWWWWW.............................
.................................................WWWWWWWWWWWWWWWWWWWWWW.............................
.................................................WWWWWWW.WWWWWWWWWWWWWW.............................
..................................................WWWWW....WWWWWWWWWWWWW............................
................................................................WWWWWWWWW...........................
................................................................WWWWWWWWWWW.........................
................................................................WWWWWWWWWWWW........................
.................................................................WWWWWWWWWWWWW......................
...............WWWWWWWWW.WWWWWWWWWWWWWWWWWWWWW....................WWWWWWWWWWWWW.....................
...........WWWWWWWWWWWWWWWWWWWWWWWWWWWWWWWWWWWW...................WWWWWWWWWWWWW.....................
.........WWWWWWWWWWWWWWWWWWWWWWWWWWWWWWWWWWWWWWW...................WWWWWWWWWWWW.....................
........WWWWWWWWWWWWWWWWWWWWWWWWWWWWWWWWWWWWWWWWWW...................WWWWWWWWWW.....................
........WWWWWWWWWWWWWWWWWWWWWWWWWWWWWWWWWWWWWWWWWWW....................WWWWWWWW.....................
.......WWWWWWWWWWWWWWWWWWWWWWWWWWWWWWWWWWWWWWWWWWWW.....................WWWWWWW.....................
.......WWWWWWWWWWWWWWWWWWWWWWWWWWWWWWWWWWWWWWWWWWWW.....................WWWWWWWW....................
.......WWWWWWWWWWW..WWWWWWWW.WWWWWWWWWWWWWWWWWWWWWW.....................WWWWWWWW....................
......WWWWWWWWW..............WWWWWWWWWWWWWWWWWWWWWW.....................WWWWWWWW....................
.....WWWWWWWWW...............WWWWWWWWWWWWWWWWWWWWW......................WWWWWWWW....................
....WWWWWWWWWW...............WWWWWWWWWWWWWWWW............................WWWWWWW....................
...WWWWWWWWWW................WWWWWWWWWWWWWWWW............................WWWWWWW....................
...WWWWWWWWWW................WWWWWWWWWWWWWWW.............................WWWWWWWW...................
...WWWWWWWWW.................WWWWWWWWWWWWWW..............................WWWWWWWW...................
...WWWWWWWW.................WWWWWWWW.....................................WWWWWWWW...................
..WWWWWWWW..................WWWWWWWW.....................................WWWWWWWW...................
..WWWWWWWW..................WWWWWWWW......................................WWWWWWW...................
..WWWWWWWWW.................WWWWWWW.......................................WWWWWWW...................
..WWWWWWWWW.................WWWWWWW.......................................WWWWWWW...................
..WWWWWWWWW.................WWWWWWWW......................................WWWWWWW...................
...WWWWWWWWW................WWWWWWWW......................................WWWWWWW...................
....WWWWWWWW................WWWWWWWW......................................WWWWWWW...................
....WWWWWWWW................WWWWWWWWW....................................WWWWWWWW...................
....WWWWWWWW.................WWWWWWWW....................................WWWWWWWW...................
....WWWWWWWWWWWWWW...........WWWWWWWWW...................................WWWWWWWW...................
....WWWWWWWWWWWWWWW...........WWWWWWWWWW.................................WWWWWWW....................
....WWWWWWWWWWWWWWWWW.........WWWWWWWWWWW..............................WWWWWWWWW....................
.....WWWWWWWWWWWWWWWWW........WWWWWWWWWWWWW........................WWWWWWWWWWWWW....................
......WWWWWWWWWWWWWWWWWWW......WWWWWWWWWWWWWW....................WWWWWWWWWWWWWWW....................
.......WWWWWWWWWWWWWWWWWWW......WWWWWWWWWWWWWWWWWWWWWWWWWWW...WWWWWWWWWWWWWWWWWW....................
........WWWWWWWWWWWWWWWWWWWW.....WWWWWWWWWWWWWWWWWWWWWWWWWWWWWWWWWWWWWWWWWWWWWWW....................
..............WWWWWWWWWWWWWWWWW...WWWWWWWWWWWWWWWWWWWWWWWWWWWWWWWWWWWWWWWWWWWWW.....................
...............WWWWWWWWWWWWWWWWW....WWWWWWWWWWWWWWWWWWWWWWWWWWWWWWWWWWWWWWWW........................
.................WWWWWWWWWWWWWWWW.....WWWWWWWWWWWWWWWWWWWWWWWWWWWWWWWWWWWWW.........................
..................WWWWWWWWWWWWWWWW.....WWWWWWWWWWWWWWWWWWWWWWWWWWWWWWWW.............................
.....................WWWWWWWWWWWWWW......WWWWWWWWWWWWWWWWWWWWWWWWWWW................................
..................WWWWWWWWWWWWWWWWW..........WWWWWWW...WWWWWWWWWWW..................................
.................WWWWWWWWWWWWWWWWWW.................................................................
.................WWWWWWWWWWWWWWWWWWW................................................................
................WWWWWWWWWWWWWWWWWWWWWW..............................................................
................WWWWWWWWWWWWWWWWWWWWWWW.............................................................
................WWWWWWWWWWWWWWWWWWWWWWWW............................................................
................WWWWWWWWWWWWWWWWWWWWWWWWW...........................................................
................WWWWWWWWWWWWWWWWWWWWWWWWWW..........................................................
.................WWWWWWWW.....WWWWWWWWWWWW..........................................................
.................WWWWWWWW.......WWWWWWWWWWW.........................................................
.................WWWWWWWWW.......WWWWWWWWWW.........................................................
..................WWWWWWWWWWWWWW.WWWWWWWWWWWW.......................................................
..................WWWWWWWWWWWWWWWWWWWWWWWWWWWWWWWWW.................................................
..................WWWWWWWWWWWWWWWWWWWWWWWWWWWWWWWWWWWW..............................................
...................WWWWWWWWWWWWWWWWWWWWWWWWWWWWWWWWWWWW.............................................
....................WWWWWWWWWWWWWWWWWWWWWWWWWWWWWWWWWWWWW...........................................
.....................WWWWWWWWWWWWWWWWWWWWWWWWWWWWWWWWWWWWWWWWWW.....................................
......................WWWWWWWWWWWWWWWWWWWWWWWWWWWWWWWWWWWWWWWWWW....................................
.............................WWWWWWWWWW..WWWWWWWWWWWWWWWWWWWWWWWWW..................................
..........................................WWWWWWWWWWWWWWWWWWWWWWWWWW................................
..................................................WWWWWWWWWWWWWWWWWWWWWWW...........................
...................................................WWWWWWWWWWWWWWWWWWWWWWW..........................
......................................................WWWWWWWWWWWWWWWWWWWW..........................
...........................................................WWWWWWWWWWWWWWW..........................
............................................................WWWWWWWWWWWWWW..........................
...............................................................WWWWWWWWWWW..........................
................................................................WWWWWWWWW...........................
....................................................................................................
....................................................................................................
....................................................................................................
....................................................................................................
....................................................................................................
....................................................................................................
....................................................................................................
....................................................................................................
